WE  textures/enemy.xpm
NO  textures/floor.xpm
EA textures/tree.xpm
SO textures/mew.xpm

F 255, 1, 120
C 4, 40, 30

          11111111111111111
          10000001110000001
          11111111111111111

          11111111111111111
          10000000100000001
          10000000100000001
          11111111N11111111
          10000000000000001
          10000000000000001
          10000000000000001
          10000000000000001
          10000000000000001
          10000000000000001
          10000000000000001
          10000000000000001
          10000000000000001
1111111111100000000000000011111111111
1000000000000000000000000000000000001
1000000000000000000000000000000000001
1000000000000000000000000000000000001
1000000000000000000000000000000000001
1000000000000000000000000000000000001
1000000000000000000000000000000000001
1000000000000000000000000000000000001
1000000000000000001000000000000000001
1000000000000000001000000000000000001
1000000000000000001000000000000000001
1000000000000000001000000000000000001
1111111111111111111111111111111111111
